1111111111111111111111111111111111111111111111111111111111111111111111111111111111111111111111111111
1000000000000000000000000000000000000000000000000000000000000000000000000000000000000000000000000001
1000000000000000000000000000000000000000000000000000000000000000000000000000000000000000000000000001
1000000000000000000000000000000000000000000000000000000000000000000000000000000000000000000000000001
1000000000000000000000000000000000000000000000000000000000000000000000000000000000000000000000000001
1000000000000000000000000000000000000000000000000000000000000000000000000000000000000000000000000001
1000000000000000000000111111111111111111111111111111111111111111111110000000000000000000000000000001
1000000000000000000000000000000000000000000000000000000000000000000001100000000000000000000000000001
1000000000000000000000000000000000000000000000000000000000000000000000110000000020000000000000000001
1000000000000000111111111111111111111111111111111111111100000000000000011000000000000000000000000001
1000000000000000000000000000000000000000000000000000000011000000000000001100000000000000000000000001
1000000000000000000000000000000000000000000000000000000001100000000000000110000000000000000000000001
1000000000000000000000000000000000000000000000000000000000110000000000000011000000000000000000000001
1000000001111111111111111111111111111111111111111110000000011000000000000001100000000000000000000001
1000000000000000000000000000000000000000000000000011000000001100000000000000100000000000000000000001
1000000000000000000000000000000000000000000000000001100000000110000000000000100000000000000000000001
1000000000000000000000000000000000000000000000000000110000000011000000000000100000000000000000000001
1000000000000000000000000000000000000000000000000000011100000001100000000000100000000000000000000001
1000000000000000000000000000000000000000000000000000000100000000111000000000100000000000000000000001
1000000000000000000000000000000000000000000000000000000100000000001000000000100000000000000000000001
1111111111111111111111111111111111111111110000000000000100000000001000000000100000000000000000000001
1000000000000000000000000000000000000000011000000000000100000000001000000000100000000000000000000001
1000000000000000000000000000000000000000001100000000000100000000001000000000100000000000000000000001
1000000000000000000000000000000000000000000110000000000100000000001000000000100000000000000000000001
1000111111111111111111111111000000000000000011000000000100000000001000000000100000000000000000000001
1000000000000000000000000001100000000000000001100000000100000000001000000000100000000000000000000001
1000000000000000000000000000110000000000000000110000000100000000001000000000100000000000000000000001
1000000000000000000000000000011000000000000000011100000100000000001000000000100000000000000000000001
1000000000000000000000000000001100000000000000000100000100000000001000000000100000000000000000000001
1000000000000000000000000000000111100000000000000100000100000000001000000000100000000000000000000001
1000000000000000000000000000000000100000000000000100000100000000001000000000100000000000000000000001
1000000000000000000000000000000030100000000000000100000100000000001000000000111111111111111110000001
1000000000000000000000000000000000100000000000000100000100000000001000000000000000000000000000000001
1000000000000000000000000000000000100000000000000100000100000000001000000000000000000000000000000001
1000000000000000000000000000000000100000000000000100000100000000001000000000000000000000000000000001
1000000000000000000000000000000000100000000000000100000100000000001000000000000000000000000000000001
1000000000000000000000000000000000100000000000000100000100000000001000000000000000000000000000000001
1000000000000000000000000000000000100000000000000100000100000000001000000000000000000000000000000001
1000000000000000000000000000000000100000000000000100000100000000001000000000000000000000000000000001
1000000000000000000000000000000000100000000000000100000100000000001111111111111111111100000000000001
1000000000000000000000000000000000100000000000000100000100000000001000000000000000000000000000000001
1000000000000000000000000000000000100000000000000100000100000000001000000000000000000000000000000001
1000000000000000000000000000000000100000000000000100000100000000001000000000000000000000000000000001
1000000000000000000000000000000000100000000000000100000100000000001000000000000000000000000000000001
1000000000000000000000000000000000100000000000000100000100000000001000000000000000000000000000000001
1000000000000000000000000000000000100000000000000100000100000000001000000000000000000000000000000001
1000000000000000000000000000000000100000000000000100000100000000001000000000000000000000000000000001
1000000000000000000000000000000000100000000000000100000100000000001000000000000000000000000000000001
1000000000000000000000000000000000100000000000000100000100000000001000000000000000000000000000000001
1000000000000000000000000000000000100000000000000100000100000000001000000000000000000000000000000001
1000000000000000000000000000000000100000000000000100000100000000001000000000000000000000000000000001
1000000000000000000000000000000000100000000000000100000100000000001000000000000000000000000000000001
1000000000000000000000000000000000111111110000000100000111110000001000000000000000000000000000000001
1000000000000000000000000000000000100000000000000100000000000000001000000000000000000000000000000001
1000000000000000000000000000000000100000000000000100000000000000001000000000000000000000000000000001
1000000000000000000000000000000000100000000000000100000000000000001000000000000000000000000000000001
1000000000000000000000000000000000100000000000000100000000000000001000000000000000000000000000000001
1000000000000000000000000000000000100000000000000100000000000000001000000000000000000000000000000001
1000000000000000000000000000000000100000000000000100000000000000001000000000000000000000000000000001
1000000000000000000000000000000000100000000000000100000000000000001000000000000000000000000000000001
1000000000000000000000000000000000100000000000000100000000000000001000000000000000000000000000000001
1000000000000000000000000000000000100000000000000100000000000000001000000000000000000000000000000001
1000000000000000000000000000000000100000000000000100000000000000001000000000000000000000000000000001
1000000011111111111111110000000000100000000000000100000000000000001000000000000000000000000000000001
1000000000000000000000010000000000100000000000000100000000000000001000000000000000000000000000000001
1000000000000000000000010000000000100000000000000100000000000000001000000000000000000000000000000001
1000000000000000000000010000000000100000000000000100000000000000001000000000000000000000000000000001
1000000000000000000000010000000000100000000000000100000000000000001111111111111111111000000000000001
1000000000000000000000010000000000100000000000000100000000000000000000000000000000000000000000000001
1000000000000000000000010000000000100000000000000100000000000000000000000000000000000000000000000001
1000000000000000000000010000000000100000000000000100000000000000000000000000000000000000000000000001
1000000000000000000000010000000000100000000000000100000000000000000000000000000000000000000000000001
1000000000000000000000010000000000100000000000000100000000000000000000000000000000000000000000000001
1000000000000000000000010000000000100000000000000111111111111111111110000000000000000000000000000001
1000000000000000000000010000000000100000000000000000000000000000000010000000000000000000000000000001
1000000000000000000000010000000000100000000000000000000000000000000010000000000000000000000000000001
1000000001111111111111111111111111100000000000000000000000000000000010000000000000000000000000000001
1000000000000000000000000000000000100000000000000000000000000000000010000000000000000000000000000001
1000000000000000000000000000000000111111111111100000000000000000000010000000000000000000000000000001
1000000000000000000000000000000000100000000000000000000000111111111111111111111111111111111110000001
1000000000000000000000000000000000100000000000000000000000100000000000000000000000000000000000000001
1000000000000000000000000000000000100000000000000000000000100000000000000000000000000000000000000001
1000000000000000000000000000000000100000000000000000000000100000000000000000000000000000000000000001
1000000000000000000000000000000000100000000000000000000000100000000000000000000000000000000000000001
1000000000000000000000000000000000100000000000000000000000100000000000000000000000000000000000000001
1000000000000000000000000000000000100000000000000000000000111111111110000000000000000000000000000001
1000000000000000000000000000000001000000000000000000000000000000000000000000000000000000000000000001
1000000000000000000000000000000010000000000000000000000000000000000000000000000000000000000000000001
1000000000000000000000000000000100000000000000000000000000000000000000000000000000000000000000000001
1000000000000000000000000000001000000000000000000000000000000000000000000000000000000000000000000001
1000000000000000000000000000010000000000000000000000000000000000000000000000000000000000000000000001
1000000000000000000000000000100000000000000000000000000000000000000000000000000000000000000000000001
1000000000000000000000000001000000000000000000000000000000000000000000000000000000000000000000000001
1000000000000000000000000010000000000000000000000000000000000000000000000000000000000000000000000001
1000000000000000000000000100000000000000000000000000000000000000000000000000000000000000000000000001
1000000000000000000000000000000000000000000000000000000000000000000000000000000000000000000000000001
1000000000000000000000000000000000000000000000000000000000000000000000000000000000000000000000000001
1000000000000000000000000000000000000000000000000000000000000000000000000000000000000000000000000001
1000000000000000000000000000000000000000000000000000000000000000000000000000000000000000000000000001
1111111111111111111111111111111111111111111111111111111111111111111111111111111111111111111111111111