1111111111111111111111111111111111111111111111111111111111111111111111111111111111111111111111111111
1000000000000000000000000000000000000000000000000000000000000000000000000000000000000000000000000001
1000000000000000000000000000000000000000000000000000000000000000000000000000000000000000000000000001
1000000000000000000000000000000000000000000000000000000000000000000000000000000000000000000000000001
1000000000000000000000000000000000000000000000000000000000000000000000000000000000000000000000000001
1000000000000000000000000000000000000000000000000000000000000000000000000000000000000000000000000001
1000000000000000001000000000000000000000000000000000000000000000000000000000000000000000000000000001
1000000000000000001000000000000000000000000000000000000000000000000000000000000000000000000000000001
1000000000000000001000000000000000000000000000000000000000000000000000000000000000000000000000000001
1000000000000000001000000000000000000000000000000000000000000000000000000000000000000000000000000001
1000000000000000001000000000000000000000000000000000000000000000000000000000000000000000000000000001
1000000000000000001000000000000000000000000000000000000000000000000000000000000000000000000000000001
1000000000000000001000000000000000000000000011111111111110000000000000000000000000000000000000000001
1000000000000000001000000000000000000000000010000000000000000000000000000000000000000000000000000001
1000000000000000001000000000000000000000000010000000000000000000000000000000000000000000000000000001
1000000000000000001000000000000000000000000010000000000000000000000000000000000000000000000000000001
1000000000000000001000000000000000000000000010000000000000000000000000000000000000000000000000000001
1000000010000000001000000000000000111111111111111111111111111110000000000000000000000000000000000001
1000000010000000001000000000000000100000000000000000000000000000000000000000000000000000000000000001
1000000010000000001000000000000000100000000000000000000000000000000000000000000000000000000000000001
1000000010000000001000000000000000100000000000000000000000000000000000000000000000000000000000000001
1000000010000000001000000000000000100000000000000000000000000000000000000000000000000000000000000001
1000000010000000001000000000000000100000000000000000000000000000000000000000000000000000000000000001
1000000010000000001000000000000000100000000000000000000000000000000000000000000000000000000000000001
1000000010000000000000000000000000100000000000000000000000000000000000000000000000000000000000000001
1000000010000000000000000000000000100000000000000000000000000001000000000000000000000000000000000001
1000000010000000000000000000000000100000000000000000000000000001000000000000000000000000000000000001
1000000010000000000000000000000000100000000000000000000000000001000000000000000000000000000000000001
1000000010000000000000000000000000100000000000000000000000000001000000000000000000000010000000000001
1000000010000000000000000000000000100000000000000000000000000001000000000000000000000010000000000001
1000000010000000000000000000000000100000000000000000000000000001000000000000000000000010000000000001
1000000010000000000000000000000000100000000000000000111111111111111111111111111111111110000000000001
1000000010000000000000000000000000100000000000000000100000000000000000000000000000000000000000000001
1000000010000000000000000000000000100000000000000000100000000000000000000000000000000000000000000001
1000000010000000000000000000000000100000000000000000100000000000000000000000000000000000000000000001
1000000010000000000000000000000000111111111111111111100000000000000000000000000000000000000000000001
1000000010000000000000000000000000000000000000000000100000000000000000000000000000000000000000000001
1000000010000000000000000000000000000000000000000000100000000000000000000000000100000000000000000001
1000000010000000000000000000000000000000000000000000100000000000000000000000000100000000000000000001
1000111111111111111111111111111000000000000000000000100000000000000000000000000100000000000000000001
1000000000000000000000000000001000000000000000000000100000000000000000000000000100000000000000000001
1000000000000003000000000000001000000000000000000000100000000000000000000000000100000000000000000001
1000000000000000000000000000001000000000000000000000100000000000000000000000000100000000000000000001
1000000000000000000000000000001000000000000000000000111111111111111111111111111100000000000000000001
1000000000000000000000000000001000000000000000000000100000000000000000000000000000000000000000000001
1000000000000000000000000000001000000000000000000000100000000000000000000000000000000000000000000001
1000000000000000000000000000000000000000000000000000100000000000000000000000000000000000000000000001
1000000000000000000000000000000000000000000000000000100000000000000000000000000000000000000000000001
1000000000000000000000000000000000000000000000000000100000000000000000000000000000000000000000000001
1111111111111111111111111111111111111111111111111111100000000000000000000000000000000000000000000001
1000000000000000000000000000000000000000000000000000010000000000000000000000000000000000000000000001
1000000000000000000000000000000000000000000000000000001000000000000000000000000000000000000000000001
1000000000000000000000000000000000000000000000000000000100000000000000000000000000000000000000000001
1000020000000000000000000000000000000000000000000000000010000000000000000000000000000000000000000001
1000000000000000000000000000000000000000000000000000000001000000000000000000000000000000000000000001
1000000000000000000000000000000000000000000000000000000000111111111111111111111111000000000000000001
1000000000000000000000000000000000000000000000000000000000010000000000000100000000000000000000000001
1000000000000000000000000000000000000000000000000000000000001000000000001000000000000000000000000001
1000000000000000000000000000000000000000000000000000000000000100000000010000000000000000000000000001
1000000000000000000000000000000000000000000000000000000000000010000000100000000000000000000000000001
1000000000000000000000000000000000000000000000000000000000000001000001000000000000000000000000000001
1000000000000000000000000000000111111111111111111111111111111111100010000000000000000000000000000001
1000000000000000000000000000000000000000000000000010000000000000010100000000000000000000000000000001
1000000000000000000000000000000000000000000000000010000000000000001000000000000000000000000000000001
1000000000000000000000000000000000000000000000000010000000000000000000000000000000000000000000000001
1000000000000000000000000000000000000000000000000010000000000000000000000000000000000000000000000001
1000000000000000000000000000000000000000000000000010000000000000000000000000000000000000000000000001
1000000000000000000000000000000000000000000000000010000000000000000000000000000000000000000000000001
1000000000000000000000000000000111111111111111111111111111111111000000000000000000000000000000000001
1000000000000000000000000000000100000000000000000000000000000001000000000000000000000000000000000001
1000000000000000000000000000000100000000000000000000000000000001000000000000000000000000000000000001
1000000000000000000000000000000100000000000000000000000000000001000000000000000000000000000000000001
1000000000000000000000000000000100000000000000000000000000000001000000000000000000000000000000000001
1000000000000000000000000000000100000000000000000000000000000001000000000000000000000000000000000001
1000000000000000000000000000000100000000000000000000000000000001000000000000000000000000000000000001
1000000000000000000000000000000100000000000000000000000000000001000000000000000000000000000000000001
1000000000000000000000000000000100000000000000000000000000000001000000000000000000000000000000000001
1000000000000000000000000000000100000000000000000000000000000001000000000000000000000000000000000001
1000000000000000111111111111111100000000000000000000000000000010000000000000000000000000000000000001
1000000000000000000000000000000000000000000000000000000000000100000000000000000000000000000000000001
1000000000000000000000000000000000000000000000000000000000001000000000000000000000000000000000000001
1000000000000000000000000000000000000000000000000000000000010000000000000000000000000000000000000001
1000000000000000000000000000000000000000000000000000000000100000000000000000000000000000000000000001
1000000000000000000000000000000000000000000000000000000001000000000000000000000000000000000000000001
1000000000000000000000000000000000000000000000000000000010000000000000000000000000000000000000000001
1000000000000000000000000000000000000000000000000000000100000000000000000000000000000000000000000001
1000000000000000000000000000000000000000000000000000001000000000000000000000000000000000000000000001
1000000000000000000000000000000000000000000000000000010000000000000000000000000000000000000000000001
1000000000000000000000000000000000000000000000000000100000000000000000000000000000000000000000000001
1000000000000000000000000000000001111111111111111111000000000000000000000000000000000000000000000001
1000000000000000000000000000000000000000000000000000000000000000000000000000000000000000000000000001
1000000000000000000000000000000000000000000000000000000000000000000000000000000000000000000000000001
1000000000000000000000000000000000000000000000000000000000000000000000000000000000000000000000000001
1000000000000000000000000000000000000000000000000000000000000000000000000000000000000000000000000001
1000000000000000000000000000000000000000000000000000000000000000000000000000000000000000000000000001
1000000000000000000000000000000000000000000000000000000000000000000000000000000000000000000000000001
1000000000000000000000000000000000000000000000000000000000000000000000000000000000000000000000000001
1000000000000000000000000000000000000000000000000000000000000000000000000000000000000000000000000001
1000000000000000000000000000000000000000000000000000000000000000000000000000000000000000000000000001
1111111111111111111111111111111111111111111111111111111111111111111111111111111111111111111111111111